X X X X X X X X X X X X X X X X X X X X X X X X X X X X X X X X X X X X X X X X
X O O O O X O O O O U X O O O O O O O X O O O O O O O O X U O O O O O O O O O X
X O X O O X O X X X X X O X O O X X O X O X X O O O O O X X X O X X X X X O O X
X O X O O X O X O O O O O X O O O X O U O X O O O O X O X O O O O O X O O O O X
X O X O O X O O O O O X X X O O O X X X X X O O X O X O X O X O O O X O X O O X
X O X O O X O X X X O X O O O O O O O O O O O O X O X O X O X O O O X O X O O X
X O X O O X O O O X O X O X X X X X X X X X X X X O X O X O X O O O X O X O O X
X O X O O O O X O X O X O X O O O O O O O O O O O O X O O O X O X O O O X O O X
X O X X X X O X O X O X O X O X X O O O O X X O O O X O O O X O X O O O O O O X
X O O O O X O X O X O X O O O X M M M M M M X O X O X O X X X O X O O O O O O X
X O O O O X O X O X O O O O O X X X X X X X X O X O O O O O O O X O O X O O O X
X O O O O O O X O X O O X O O O O O O O O O O O X O O O O O X O X X X X O X O X
X O X X O O O X O O O O X O X X X X O P O X X X X X X X O O X O O O O O O X O X
X O U X O X X X O X X O X O X O O O O O O O O O O O O O O O X O X X X X X X O X
X O O X O X O O O O O O X O X O O O O X O O O O O O O X X X X O X U O O O O O X
X O O X O O O O O O O O X O O O O O O X O O O O O O O O O O O O X O O O O O O X
X X X X X X X X X X X X X X X X X X X X X X X X X X X X X X X X X X X X X X X X